0,0,0,0,1,1,1,1,1
0,0,0,0,0,0,0,0,0
0,A10,A20,A30,A40,A50,A60,0,0
0,1,1,1,1,1,1,0,0
0,1,1,1,1,1,1,0,0
0,0,0,0,0,0,0,0,0
0,B10,B20,B30,B40,B50,B60,0,0
0,1,1,1,1,1,1,0,0
0,1,1,1,1,1,1,0,0
0,0,0,0,0,0,0,0,0
0,C10,C20,C30,C40,C50,C60,0,0
0,1,1,1,1,1,1,0,0
